NO ./img/onepiece_wall_chopper.png
SO ./img/onepiece_wall_nami.png
EA ./img/onepiece_wall_monkey.png
WE ./img/onepiece_wall_nico.png
F 175, 143, 133  
C 153, 204, 255



        1111111111111111111111111
        1000000000110000000000001 
        1011000001110000000000001
        1001000000000000000000001111111111111
        1111111111111011000001110000000000001
            100000000011000001110111100111111
            11110111111111011100000010001
            11110111111111011101010010001
            11000000110101011100000010001
  11111     10000000000000001100000010001
  10011     10000000000000001101010010001
  11111     11000001110101011111011110N0111
            11110111 1110101 101111010001
            11110111 1111111 111111111011
               101                   101
               101                   101
               101                   101
               101                   101
               1011111111111111111111101
               1000000000000000000000001
               1111111111100111111111111