NO ./img/wall_01.png
SO ./img/wall_01.png
EA ./img/wall_01.png
WE ./img/wall_01.png

C 135, 206, 235
F 194, 178, 128

111111111111
100000000001
100010011101
100000000101
101110001101
100000000001
100011111111
10001
10011
10S01
11111