NO ./img/Military6.png
SO ./img/Military8.png
EA ./img/Military5.png
WE ./img/Military2.png

C 9, 24, 51
F 143, 188, 143

11111111111111111111
10000000000000000001
10000000001000110111
10000100001001000001
10000000000011111001
10000000000000000001
10000S00100111111001
11111111100000000001
        111111111111