NO ./img/wall_02.png
SO ./img/wall_02.png
EA ./img/wall_04.png
WE ./img/wall_04.png

C 105, 105, 105
F 127, 127, 127

111111111111111
100000000000001
1000000S0000001
100000000000001
111111111111111