1111111111111111
10P0P00000C00001
1000000000X00001
1000C00000000001
10000000000000E1
1111111111111111