1111111111111111111111111111111
1P0000000000C000000000000000001
1000000000000000000000000000001
100000C000000000000000000000001
10000000000000000000000000000E1
1000000000000000000000000000001
1111111111111111111111111111111