111111111111111
1P0000000000C01
10000C000000001
100000000000001
10000C0000000E1
111111111111111