1111111111111111111111111
1111111000000000001111111
111111000000P000000111111
1111100000000000000011111
1111000000000000000001111
111100C0000X00000X0001111
1111000000000000000001111
111100000000000X000001111
1111000000000000000C01111
111100000X000000000001111
1111000000000000000001111
11110000000000000000E1111
1111111111111111111111111