1111111111111111111111111
1111111000000000001111111
111111000000P000000111111
11111000000000000C0011111
1111000000000000000001111
111100C000000000000001111
1111000000000000000001111
111100000000000C000001111
1111000000000000000C01111
111100000C000000000001111
1111000000000000000001111
11110000000000000000E1111
1111111111111111111111111