1111111111111111
1P000000000C0001
1000000000000001
1000C00000000001
1000000000000E01
1111111111111111
